15
.#.............
.#.............
.#.......S.....
.#.............
.#.............
.#.............
.##............
..####.........
.....##........
......##.......
.......###.....
.........##....
..........###..
............###
G..............
 