10
S#....#...
.#..#.###.
.####.....
....#..#.#
..#...##.#
.###...#.#
..#..#....
#....#.###
#.#..#.#..
######...G