20
....................
##..................
.####...............
....#####.S.........
........#...........
........###.........
..........####......
.............###....
...............##...
................##..
.................#..
..................#.
..................#.
..................#.
..................#.
..................#.
...G................
....................
....................
....................